{
  "version": "2.0",
  "map": {
    "寅": {
      "木": "旺",
      "火": "相",
      "水": "休",
      "金": "囚",
      "土": "死"
    },
    "卯": {
      "木": "旺",
      "火": "相",
      "水": "休",
      "金": "囚",
      "土": "死"
    },
    "辰": {
      "土": "旺",
      "金": "相",
      "火": "休",
      "木": "囚",
      "水": "死"
    },
    "巳": {
      "火": "旺",
      "土": "相",
      "木": "休",
      "水": "囚",
      "金": "死"
    },
    "午": {
      "火": "旺",
      "土": "相",
      "木": "休",
      "水": "囚",
      "金": "死"
    },
    "未": {
      "土": "旺",
      "金": "相",
      "火": "休",
      "木": "囚",
      "水": "死"
    },
    "申": {
      "金": "旺",
      "水": "相",
      "土": "休",
      "火": "囚",
      "木": "死"
    },
    "酉": {
      "金": "旺",
      "水": "相",
      "土": "休",
      "火": "囚",
      "木": "死"
    },
    "戌": {
      "土": "旺",
      "金": "相",
      "火": "休",
      "木": "囚",
      "水": "死"
    },
    "亥": {
      "水": "旺",
      "木": "相",
      "金": "休",
      "土": "囚",
      "火": "死"
    },
    "子": {
      "水": "旺",
      "木": "相",
      "金": "休",
      "土": "囚",
      "火": "死"
    },
    "丑": {
      "土": "旺",
      "金": "相",
      "火": "休",
      "木": "囚",
      "水": "死"
    }
  }
}